XXXXXXXXXXXXXXXXXXX
X                 
X  
X
X
X             
X                 X 
X                XX
X               XXX
XXXXXXXXXXXXXXXXXXX