XXXXXXXXXXXXXXXXXXXXXXXXXXXXXXXX
X
X                                FF
X                                FF
X              XXXXXX    XXXXX    F  
X       X  X                    X
X       XXXX                    X 
X               XXX             X
X              XXXX             X
XXXXXXXXXXXXXXXXXXXXXXXXXXXXXXXXX