XXXXXXXXXXXXXXXXXXXXXXXXXXXXXXXX
X
X
X
X              XXXXXX    XXXXX
X       X  X                    X
X       XXXX                    X 
X               XXX             X
X              XXXX             X
XXXXXXXXXXXXXXXXXXXXXXXXXXXXXXXXX