XXXXXXXXXXXXXXXXXXXXXXXXXXXXXXXX
X
X                                FF
X                                FF
X              XXXXXX    XXXXX    F  
X       X  X                    X
X       XXXX              S     X 
X               XXX       S     X
X              XXXX       S     X
XXXXXXXXXXXXXXXXXXXXXXXXXXXXXXXXX