XXXXXXXXXXXXXXXXXXXXXXXXXXXXXXXXXXXXXXX
X                                 
X                                                                   FF
X                  XXXXXXXXXX                              S   S    FF
X                                                 XXXXXXXXXXXXXXXXX  F X
X                                           XXXXXX                XXXXXX
X                 XXXXXXXXXXXXXXXXXXXXXXXXXXX 
X                XX 
X               XXX 
XXXXXXXXXXXXXXXXXXX 