XXXXXXXXXXXXXXXXXXXXXXXXXXXXXXXXXXXXXXX
X                                 
X                  
X                  XXXXXXXXXXXXXXXXXXXX
X                  
X                             
X                 XXX  XXXXXXXXXXXXXX 
X                XX 
X               XXX 
XXXXXXXXXXXXXXXXXXX 